25 15
4  2  2  2  2  2  2  2  2  2  2  2  2  2  2  2  2  2  2  2  2  2  2  2  5 
3  0  0  0 99 99  0  0  0  0  0  0  0  0  0  0  0  0  0  0  0  0  0  99 3 
3  0  4  5 99 93  11 0  4  5  0  4  5  0  4  5  0  4  5  0  4  5  0  4  14
3  0  7  6  0  9  6  0  7  6  0  7  6  0  7  6  0  7  6  0  7  6  0  7  14
3  0  0  0 99 99  0  0  0  0  0  0  0  0  0  0  0  0  0  0  0  0  0 16  3 
3  0  4  5 99 90  11 0  4  5  0  4  5  0  4  5  0  4  5  0  4  5  0  4  14 
3  0  7  6  0  9  6  0  7  6  0  7  6  0  7  6  0  7  6  0  7  6  0  7  14
3  0  0  0 99 99  0  0  0  0  0  0  0  0  0  0  0  0  0  0  0  0  0 16  3 
3  0  4  5 99 91  11 0  4  5  0  4 10  0  4  5  0  4  5  0  4  5  0  4  14 
3  0  7  6  0  9  6  0  7  6  0  8  0  85  7  6  0  7  6  0  7  6  0  7  14 
3  0  0  0 99 99  0  0  0  0  0  0  0  0  0  0  0  0  0  0  0  0  0 16  3 
3  0  4  5 99 92  11 0  4  5  0  4  5  0  4  5  0  4  5  0  4  5  0  4  14 
3  0  7  6  0  9  6  0  7  6  0  7  6  0  7  6  0  7  6  0  7  6  0  7  14
3  0  0  0  0  0  0  0  0  0  0  0  0  0  0  0  0  0  0  0  0  0  0 99  3 
7  2  2  2  2  2  2  2  2  2  2  2  2  2  2  2  2  2  2  2  2  2  2  2  6 
