25 15
4 2  2   2  2  2  2  2 12 12  2  2  2 12  2 12  2  2  2  2  2  2  2  2  5 
3 93 99  0  0  0  0  0 13  6  16  0  0  3  0  3  0  0  0  0  0  0  0  85  3 
3 92 99  0  11  0 11  0  8 0  0 11  0  3  0  3  0  9 12  2  2  2  5  0  3 
3 91 11  0  3  0  3  0  0  0  4  6  0  8  0  8  0  16 3  0  0  0  3  0  3 
3 90 3   0  3  0  3  0  11 0  3  0  0  0  0  0  0  9 14  0 11  0  8  0  3 
3  2  6  0  8  0  3  0  3  0  3  0 11  0 11  0  0  0  3  0  3  0  0  0  3 
3  0  0  0  0  0  3  0  8  0  8  0  3  0  3  0  4  2  6  0  8  0  9  2 14 
3  0 11  0 11  0  8  0  0  0  0  0  3  0  3  0  8  0  0  0  0  0  0  0  3 
3  0  3  16 3  0  0  0  4  2 10  0  8  0  8  0  0  0  9 10  0  9  5 0  3 
3  0  3  0  3  0 11  0  3  0  0  0  0  0  0  0  11  0  0  0  0  0  3  0  3 
3  0  3  0  8  0  8  0  8  0  9  2 12  2 10  0  8  0  9  2 10  0  8  0  3 
3  0  3  0  0  0  0  0  0  0  0  0  3  0  0  0  0  0  0  0  0  0  0  0  3 
3  0  8  0  9  2  2  2  2  2 10  0  8  0  9  2  2  2  2  2 10  0  9  2 14 
 3  0  0  0  0  0  0  0  0  0  0  0  0  0  0  0  0  0  0  0  0  0  0  16 3 
 7  2  2  2  2  2  2  2  2  2  2  2  2  2  2  2  2  2  2  2  2  2  2  2  6 
