25 15
 4  2  2  2  2  2  2  2  2  2  2  2 12  2  2  2  2  2  2  2  2  2  2  2 5
 3  0  0  0  0  0  0  0  0  0  0  0  3  0  0  0  0  0  0  0  0  0  0  0 3
 3  0  9  2  2  2 10  0  4  2 10  0  3  0  9  2 10  0  4  2 10  0 11  0 3
 3  0  0  0  0  0  0 16  3  0  0  0  3  0  0  0  0  0  3 16  0  0  3  0 3
13  2  2  2 10  0  9  2  6  0  9  2  6  0  9  2 10  0  3  0 11  0  3  0 3
 3  0  0  0  0  0  0  0  0  0  0  0  0  0  0  0  0  0  3  0  3  0  3  0 3
 3  0  9  2  5  0  9 10  0  4 10 99 99  9  5  0  9  2  6  0  8  0  8  0 3
 3  0  0  0  3  0  0  0  0  3 93 92 90 91  3  0  0  0  0  0  0  0  0  0 3
 3  0 11  0  7  2  2 10  0  7  2  2  2  2  6  0  9  2  2 10  0  9  2  2 3
 3  0  3  0  0  0  0  0  0  0  0  0  0  0  0  0  0  0  0  0  0  0  0  0 3
 3  0  8  0 11  0 11  0  9  2 10  0 11  0  9  2 12  2  2  2 10  0 11  0 3
 3  0  0 16  3  0  3  0  0  0  0  0  3  0  0  0  3  0  0  0  0 16  3  0 3
 3  0  9  2  6  0  8  0 11  0  9  2  6  0 11  0  8  0  9  2  2  2  6  0 3
 3  0  0  0  0  0  0  0  3  0  0  0  0  0  3  0  0  0  0  0  0  0  0  0 3
 7  2  2  2  2  2  2  2 15  2  2  2  2  2 15  2  2  2  2  2  2  2  2  2 6
